{
	"doors": [],
	"coffee": [
		[2, 2],
		[4, 2],
		[6, 2],
		[10, 2],
		[3, 3],
		[8, 3],
		[6, 6],
		[10, 5],
		[1, 6],
		[4, 6]
	],
	"grass": [
		[2, 7],
		[3, 7],
		[5, 7],
		[7, 7],
		[9, 7],
		[10, 7]
	],
	"columns": 12,
	"rows": 9,

	"graphical_map": [
		16, 18, 31, 31, 31, 31, 31, 11, 16, 17, 25, 17, 7, 39, 39, 47, 39, 47, 39, 19, 39, 31, 19, 0, 7, 7, 39, 39, 39, 39, 39, 39, 39, 31, 39, 8, 1, 1, 2, 39,
		47, 31, 31, 3, 31, 31, 39, 29, 24, 17, 30, 31, 39, 39, 12, 23, 5, 5, 5, 21, 18, 31, 19, 39, 47, 31, 19, 39, 39, 39, 31, 31, 7, 31, 39, 31, 39, 39, 39,
		31, 39, 39, 31, 31, 7, 7, 39, 39, 3, 31, 31, 31, 39, 31, 0, 2, 28, 1, 1, 27, 46, 1, 2, 7, 7, 0, 42, 32
	],

	"collision_map": [
		0, 6, 0, 0, 0, 0, 0, 8, 4, 4, 0, 0, 2, 0, 0, 1, 0, 1, 0, 14, 0, 0, 12, 0, 0, 3, 0, 0, 0, 0, 0, 0, 0, 0, 0, 8, 0, 0, 3, 0, 1, 0, 0, 11, 0, 0, 0, 8, 0, 4,
		2, 0, 0, 0, 9, 4, 5, 5, 5, 4, 2, 0, 14, 0, 1, 0, 14, 0, 0, 0, 0, 0, 2, 0, 0, 0, 0, 0, 0, 0, 0, 0, 0, 0, 0, 3, 0, 0, 11, 0, 0, 0, 0, 0, 9, 1, 0, 0, 1, 1,
		0, 1, 1, 1, 1, 1, 0, 0
	],

	"id": "03"
}
